30,30,30,30,30,30,30,30,30,30,30,30,30,30,30,30,30,30,30,30,30,30,30,30,30,30,30,30,30,30
30,30,30,30,30,30,30,30,30,30,30,30,30,30,30,30,30,30,30,30,30,30,30,30,30,30,30,30,30,30
30,30,30,30,30,30,30,30,30,30,30,30,30,30,30,30,30,30,30,30,30,30,30,30,30,30,30,30,30,30
30,30,30,30,30,30,30,30,32,30,30,30,30,30,30,30,30,30,30,30,31,31,30,30,30,30,30,30,30,30
30,30,30,30,30,32,32,32,31,31,31,32,32,30,30,30,30,30,30,30,31,31,31,30,30,30,30,30,30,30
30,30,30,32,32,32,31,31,31,31,31,32,32,32,32,32,30,30,30,30,30,30,31,31,31,30,30,30,30,30
30,30,30,30,30,30,30,31,31,31,31,30,30,32,32,30,30,30,30,30,30,30,31,31,31,31,31,30,30,30
30,30,30,30,30,30,30,31,31,31,30,30,30,30,30,30,30,30,30,30,30,30,30,30,30,31,31,30,30,30
30,30,30,30,30,30,30,31,30,30,30,30,30,30,30,30,30,30,30,32,32,30,30,30,30,31,31,30,30,30
30,30,30,30,31,31,31,31,31,30,30,30,30,30,30,30,32,30,32,32,32,32,30,30,30,30,30,30,30,30
30,30,30,30,30,31,31,31,31,30,30,32,30,30,30,30,32,31,31,31,31,32,32,30,30,30,30,30,30,30
30,30,30,32,30,30,31,31,31,30,32,32,30,30,30,30,30,32,32,30,31,31,31,30,30,30,30,30,30,30
30,30,30,32,30,30,30,31,31,30,30,32,32,32,30,30,30,30,30,30,30,31,31,32,30,30,30,30,30,30
30,30,32,32,30,30,30,30,31,31,30,30,30,32,32,30,30,30,30,30,30,30,30,30,30,30,30,30,30,30
30,30,32,30,30,30,30,30,30,30,30,30,30,32,32,30,30,30,30,30,30,30,30,30,30,30,30,30,30,30
30,30,32,32,30,30,30,30,30,30,30,32,32,32,30,30,30,32,32,30,30,30,31,30,30,30,30,30,30,30
30,30,30,32,32,30,30,30,30,30,30,30,32,32,32,32,32,31,31,31,31,31,31,30,30,30,30,30,30,30
30,30,30,32,32,30,30,30,30,30,30,30,30,30,30,32,32,32,31,31,31,31,30,30,30,30,30,30,30,30
30,30,32,32,30,30,30,30,30,30,30,30,30,30,30,30,30,32,31,31,32,30,30,30,30,30,30,30,30,30
30,30,32,32,30,30,30,30,30,30,30,30,30,30,31,31,31,31,31,30,30,30,30,30,30,30,30,30,30,30
30,30,30,32,30,30,32,32,32,32,30,30,32,30,30,31,31,31,31,31,31,30,30,30,32,32,32,30,30,30
30,30,30,32,32,30,32,30,30,32,32,32,32,30,30,30,30,30,30,30,30,30,30,30,32,32,30,30,30,30
30,30,30,30,30,32,32,32,30,30,30,30,30,30,30,30,32,32,30,30,30,30,30,30,30,32,30,30,30,30
30,30,30,30,30,30,30,30,30,30,30,30,30,30,30,30,32,32,30,30,30,30,32,32,31,32,30,30,30,30
30,30,30,30,30,30,30,30,30,30,30,30,32,32,32,32,32,32,32,30,30,32,32,31,31,30,30,30,30,30
30,30,30,30,30,30,30,30,30,30,30,30,32,32,32,32,30,30,32,32,32,31,31,31,31,32,30,30,30,30
30,30,30,30,30,30,30,30,30,30,30,30,30,30,30,30,30,30,30,32,32,32,32,31,31,31,31,30,30,30
30,30,30,30,30,30,30,30,30,30,30,30,30,30,30,30,30,30,30,30,30,30,30,30,30,30,30,30,30,30
30,30,30,30,30,30,30,30,30,30,30,30,30,30,30,30,30,30,30,30,30,30,30,30,30,30,30,30,30,30
30,30,30,30,30,30,30,30,30,30,30,30,30,30,30,30,30,30,30,30,30,30,30,30,30,30,30,30,30,30
