128,128,128,128,128,128,128,128,128,128,128,128,128,128,128,128,128,128,128,128,128,128,128,128,128,128,128,128,128,128
128,128,128,128,128,128,128,128,128,128,128,128,128,128,128,128,128,128,128,128,128,128,128,128,128,128,128,128,128,128
128,128,128,128,128,128,128,128,128,128,128,128,128,128,128,128,128,128,128,128,128,128,128,128,128,128,128,128,128,128
128,128,128,128,128,128,128,128,128,128,128,128,128,128,128,128,128,128,128,128,128,129,129,129,129,128,128,128,128,128
128,128,128,128,128,128,128,128,128,128,128,128,128,128,128,128,128,128,129,128,128,129,129,129,129,129,128,128,128,128
128,128,128,128,129,128,128,128,128,128,128,128,128,128,128,129,129,129,129,129,129,129,128,128,129,129,129,128,128,128
128,128,128,128,129,129,129,129,129,128,128,128,128,128,128,129,128,128,128,129,129,129,128,128,128,128,128,128,128,128
128,128,128,129,129,129,129,129,129,128,128,128,128,129,128,128,129,128,128,129,129,129,128,128,128,128,128,128,128,128
128,128,128,129,129,129,129,129,129,129,128,128,128,129,129,129,129,129,128,128,128,129,129,129,128,128,128,128,128,128
128,128,128,128,129,129,128,129,129,129,128,129,129,128,128,129,129,128,128,128,128,128,128,128,128,128,128,128,128,128
128,128,128,128,128,128,128,129,129,129,129,128,129,130,130,130,130,130,128,128,128,128,128,128,128,128,128,128,128,128
128,128,128,128,128,128,128,129,129,128,129,129,130,130,158,158,158,130,128,128,128,128,128,128,128,128,128,129,128,128
128,128,128,128,128,128,128,128,128,128,129,129,130,158,158,158,158,130,128,128,128,128,128,129,129,128,128,129,128,128
128,128,128,128,128,128,128,128,128,128,128,129,129,130,130,130,130,129,128,128,128,128,128,129,129,129,128,129,128,128
128,128,128,128,128,128,128,128,128,128,128,128,129,129,129,129,128,128,128,128,128,128,128,129,128,129,129,129,128,128
128,128,128,128,128,128,128,128,128,128,128,128,128,128,128,128,128,128,128,128,128,128,128,129,129,129,128,128,128,128
128,128,128,128,128,128,128,128,128,128,128,128,128,128,128,129,129,128,128,128,128,128,128,128,128,128,128,128,128,128
128,128,128,128,128,128,128,128,128,128,128,128,128,129,129,129,128,128,128,128,128,128,128,128,128,128,128,128,128,128
128,128,128,128,128,128,128,128,128,128,128,128,128,128,128,128,128,128,128,128,128,128,128,128,128,128,128,128,128,128
128,128,128,128,129,129,128,128,128,128,128,128,128,128,128,128,128,128,128,128,129,128,128,128,128,128,128,128,128,128
128,128,128,129,130,129,128,128,128,128,128,128,128,128,128,128,128,128,128,128,128,128,128,128,128,128,128,128,128,128
128,128,129,128,129,129,128,128,128,128,128,128,128,128,128,128,128,128,129,128,129,128,128,128,128,128,128,129,128,128
61,61,61,61,61,129,128,128,128,128,128,128,128,128,128,128,128,128,128,129,129,128,128,128,128,128,128,128,128,128
61,61,61,61,61,61,61,61,61,61,61,61,61,128,128,128,128,128,128,128,128,128,130,128,128,128,128,128,128,128
61,61,61,60,61,61,61,61,61,61,61,61,61,61,61,128,61,61,61,61,61,61,61,130,61,61,61,61,61,61
61,61,61,60,61,61,61,61,61,60,60,61,61,61,61,61,61,61,61,61,61,61,61,61,61,61,61,61,61,61
60,60,60,60,61,60,60,60,60,61,61,60,61,61,60,61,61,61,60,61,61,60,60,61,61,61,61,61,60,61
60,60,60,60,60,60,60,60,60,61,60,60,60,61,60,61,61,60,60,60,61,60,60,61,61,60,61,60,60,61
60,61,60,60,60,60,60,60,61,60,60,60,60,60,60,60,60,60,60,60,60,60,60,60,60,60,60,60,60,60
60,61,60,60,60,60,60,60,61,60,60,60,60,60,60,60,60,60,60,60,60,60,60,60,60,60,60,60,60,61
